######+++#
+...#....+
+...#....+
+...x....+
+...#....+
+...#....+
+...#....+
#+++######
