#++#######
#..!.*...#
#..!._...+
#..!.....#
+..!.....#
+..##x#..#
+.....#..#
####++####
