#++++++++#
#........+
#........+
####x##..+
+.....##.+
+......###
+........#
#++++++++#
