######+++#
+...#....+
+...#....+
+...#!!#.+
+...#..x.+
+...x..#.+
+...#..#.+
#+++######
