####++####
#........#
#.##!!##.#
+.#....#.+
+.#.__.#.+
#.######.#
#........#
####++####
