####++####
#........#
#.######.#
+.######.+
+.######.+
#.######.#
#........#
####++####
