#####+####
#........#
#........#
#.###o##.#
#.#,,,,o.+
+.o,,,,#.#
#.###o##.#
#........#
#####+####
          
