######+###
#,,,,,,,,#
#,,~~~,,,#
#,,~~~,,,#
+,,~~~~,,+
#,,~~~~,,#
#,,,~,,,.#
#,,,,,,,,#
####+#####
          
