###+######
#....#...#
#....#...#
#....#...+
###x##...#
#....#...#
+....x...#
#....#...#
#######+##
          
