########+#
#.....#..#
#.....x..#
#.....#..#
#.....#..+
#######..#
+........#
#........#
####+#####
          
