                              
                              
                              
                              
                              
      ################        
     #########.......+        
    ####.......#######        
    ###....#..##              
    ##$..A##..#               
     ##...##.##               
      ###..#.##               
        ##....###             
          ##....#++##         
           ###..#..###        
             ##......##       
              ###..#..#       
                #++##.##      
           ####     #..#      
         ###..#######..#      
         +.....(.##...##      
         ##..........##       
          ############        
                              
                              
                              
                              
                              
                              
                              
