                              
                              
                              
           ###++###           
           #......#           
           #......#           
           ###..###           
           #......#           
           #......#           
       #######..#######       
       #..#..#..#..#.(#       
       #..#..#..#..#..#       
       +..............+       
       +..............+       
       #..#..#..#..#..#       
       #..#.$#..#..#..#       
       ######...#######       
          ##......#           
          ##......#           
          ####..###           
           #......#           
           #......#           
           ###++###           
                              
                              
                              
                              
                              
                              
                              
