                              
                              
                              
           ###++######        
           #.........#        
       #####.........###      
       #...#..#####....#      
       #...#....#......#      
       ###.#....#....###      
       #...##.#####....#      
       #....#...#......#      
       ###..#...#....###      
       +....#.#####...+       
       +..............+       
       ###......#..#..#       
       #....###.#..#..#       
       #....#...#######       
       ###..#.....#           
       #....###...#           
       #....#...###           
       ######.....#           
           ###....#           
           ###++###           
                              
                              
                              
                              
                              
                              
                              
