#++++++++++#
+,,&&&&&,,,+
+,&&&&&&~,,+
+,,&&~~~~,,+
+,,,~~~~~&,+
+,,~~,~~,&&+
+,~~,,&&&&&+
+&~~&&&&&&&+
+&&&&,,,,,,+
+,&&&,,,,,,+
+,,,,,,,,,,+
#++++++++++#
