#++++++++++#
+&&&&&&&&&&+
+&&&&&&&&&&+
+&&&&,,,,&&+
+&&,,,,,,,,+
+&&,,,,,,,,+
+&,,,,,&,,,+
+&&,,,&&,,,+
+&&,,&&&,,,+
+&&,,,&&,,,+
+&&&,,,,,,,+
#++++++++++#
