#++++++++++#
+&&&&&&&,,,+
+&&&&&&&&&,+
+,,&&^^&&&,+
+,&&^^^&&&,+
+,&&^V^&&&&+
+,&^VV^&&&&+
+&~^^^&&&&&+
+&&&&&&&,,,+
+,&&&,,,,,&+
+,,,,,,,,&&+
#++++++++++#
