#++++++++++#
+,,&&&&&,,,+
+,&&&&&&,,,+
+,,,,&&&&,,+
+,,,,,,,,,,+
+,,,,,,,,&&+
+,,&,,,,,&&+
+&&&&&,,,&&+
+,&&&&&,,,,+
+,&&&&&,,,,+
+,,,&&&,,,,+
#++++++++++#
