#++++++++++#
+,,&&&&&,,,+
+,&&&&&&,,,+
+&&&&&&&&,,+
+&&&&&&&&,,+
+&&,,&&&&&&+
+&&&,,,&&&&+
+&&&&&,,&&&+
+,&&&&&,,,,+
+,,,&&&,,,,+
+,,,,,&,,,,+
#++++++++++#
