#++++++++++#
+,,,,,,,,,,+
+,,,,,,,,,,+
+,,,,~~~~,,+
+,,~~~~~~,,+
+,,~~,,~~,,+
+,~~~,,~~,,+
+,,~~~~~~,,+
+,,~~~~~,,,+
+,,,,,,,,,,+
+,,,,,,,,,,+
#++++++++++#
