                    
                    
        #+###       
      ###...###     
     ##..AAA####    
     ##.########    
 #####K.K########## 
 ###............### 
 ##..########.....# 
 #.....#####.....## 
 #......####...#### 
 ###...........#### 
 #####.......###    
     ###..<.####,   
   ,,#####>#####&&  
   ,&&&&&,,,,,&&&&  
   ,,&&&&&&,&&&&&&  
    ,,,&&&&&&&&&&   
     ,,,&&&&&&&,    
      ,,,,,,,,,     
