                    
                    
        #+###       
        #A..#       
     #####x#####    
     #.........#    
 #####.........#### 
 #...#.........#.A# 
 #..A#..A.A.A..x..# 
 +...x.........#..+ 
 #...#.........#..# 
 #...#.........#### 
 #####.........#    
     #....<....#,   
   ,,####!>!####,,  
   ,,,,,,,,,,,,,,,  
   ,,,,,,,,,,,,,,,  
    ,,,,,,,,,,,,,   
     ,,,,,,,,,,,    
      ,,,,,,,,,     
