^V^^V^^^^^^^^^^^^^^--------------------------
^^^^^^^^&&&&^^^^^---------------------------~
^V^V^^^&&&&&&,,,------,--------------------~~
^^^^^&&&&&&&&,,,,---,,,,,-----------------~~~
^^^^&&&&&#&&&,,,,,,,,,,,,,,,,,,------,----~~~
^^^^&&&&&;;;&&,,,,,,,,,,,,,,,,,,,,,,,,,--~~~~
^^V^&&&&&&&;;;;,,,,,,,,,,,,,,,,,,,,,,,,,,~~~~
^^^^^&&&&&&;~";;;,,,,,,,,,,,,,,,,,;;;#,,~~~~~
^^^^^^&&&&&;~~"&;;;;;;;,,,,,,,,,,;;",,~~~~~~~
^^^^^^^&&&&;&~"&&,,,,";;;,,,,,;;;;,,,~~~~~~~~
^^V^^^^^&&&;&~~"&,,,,,,";;;;;;;,,,,,,~~~~~~~~
^VVV^^^^&&&;&&~"&,,,,",,,,,,,;,,,",,~~~~~~~~~
^^VV^^^^^&&;;&~~&,,,,,,,,,,,,;,,,,,~~~~~~~~~~
^^VV^^^^^&&&;;&~~,,,,,,,,,,,;;,,,,~~~~~~~~~~~
^VV^^^^^&&;;;;;,~~,,,,,,,,,;;,,,,~~,~~~~~~~~~
^^^^^^^&&;;""";""~~,,,,,,,,;,,,,~~,,~~~~~~~~~
^^^^^"";;;""""#"~~~~~,,,,,,;,,~~~,,,~~~~~~~~~
^^^^&&&;&&""""~~~,,~~~~~~~~=~~~,,,,,~~~~~~~~~
^^^^&&&;&&""~~~,,,,,,,,,,,,;,,,,,,,,,~~~~~~~~
^^^^^"";&&&~~,,,,,,,,,,,,,,;,,,,,,,,,~~~~~~~~
^^^^^"";&&~~,,,,,,,,;;;;;;;;;;;;;;,,,~~~~~~~~
^^^^^&&;&~~,,,;;;;;;;,,,,,,;,,,,";",,,~~~~~~~
^^^^^&&;~~&&,,;,,,,,,,,,,,,;,,,,"#",,,~~~~~~~
^^^^^;;;=;;;;;;,,,,,,,,,,,,;,,,,""",,,~~~~~~~
^^^^&#&~~&&&&&,,,,,,,,,,,,,;,,,,,,,,,,~~~~~~~
^^^&&&~~&&&&&&&,,,,,,,,,,,,;,,,,,,,,,,~~~~~~~
^^^&&&~&&&&&&&&,,,,,,,,,,,,;,,,,,,,,,~~~~~~~~
^^^~~~~~&&&&&&&&&&&&,,,,,,,;,,,,,,,,,~~~~~,,~
^^^~~~~~~~&&&&&&&&&&,,,;;;;;,,,,,,,,~~~~~~,,~
^^^^~~~~~~&&&&&&&&&&,,,;,,,;,,,,,,~~~~~~~,,,~
^^^^~~~~~~^^^&&&&&&&;;;;,,,;,,"",,~~~~~~,,&,~
V^^^^~~~~^^^^&&&&&&;;,,,,,,;,,"",,~~~~~~,&&,~
V^^^^^~^^^^^&&&&&&";",,,,,,*,,"",,~~~~~~,&&,~
VV^^^^^^V^"&&&&&&&"*",,,,,,;,,,,,~~~~~~~~,,,~
VV^^^^V^^&&&&&&&&&";",,,,,,;;,,,,~~~~~~~~~~~~
V^^^^^^^&&&&&&&&&;;;,,,,,,,,;~~~~~~~~~~~~~~~~
^^^^^^&&&&&&&&&&&;,,,,,,,,,~=~,,,,,~~~~~~~~~~
^^^&&&&&&&&&&&&&&;,,,,,~~~~~;,,,,,,,~~~~~~~~~
^^&&&&&&&&&&&&&&&;,,,~~~,,,,;,,,,,,,,~~~~~~~~
^^"&&&&&&&&&&&&&&;,,~~,,,,,,;;;;;;;",~~~~~~~~
^^&&&&;;;;;;;;;;;;,~~,,,,,,,,,,,,,;,,~~~~~~~~
^^&&*;;""&&&&&&&~~~~,,,,,,""",,,,,;,,,~~~~~~~
^^^&&&"""&&&&&&~~&&,,,,,,,""",,,,,*,,,~~~~~~~
^^^&&&&&&&&&&&&&&&&,,,,,,,,,,,,,,,,,,,~~~~~~~
^^^&&&&&&&&&&&&&&&&,,,,,,,,,,,,,,,,,,,~~~~~~~
