~~~~~~~~~~~~~~~~~~~~~~~~~~~~~~~~~~~~~~~~~~~~~~~~
~~~~~~~~~~~~~~~~~~~~~~~~~~~~~~~~~~~~~~~~~~~~~~~~
~~~~~~~~~~~~~~~~~~~~~~~~~~~~~~~~~~~~~~~~~~~~~~~~
~~~~~~~~~~~~~~~~~~~~~~~~~~~~~~~~~~~~~~~~~~~~~~~~
~~~~~~~~,,,,,,,,,,,,,,,,,,,,,,,,,,,,,,,,,~~~~~~~
~~~~~~,,,,,,,,,,,,,,,,,,,,,,,,,,,,,,,,,,,,~~~~~~
~~~~~,,,,,,,,,,,,,,,,,,,,,,,,,,,,,,,,,,,,,,~~~~~
~~~~,############,,,,,,,,,,,,,,##o#########~~~~~
~~~,,#..........#,,,,,,,,,,,,,,#*..#%%%%%.#,~~~~
~~~,~#.((.(((.((#,,,,,,,,,,,,,,o.h.#%%%%%.#,,~ ~
~~~~~#9.........################.O.#%%%%%.#,,~~~
~~~~,#.((((.(.((#$$$$$.....$$$$#.h.#%%%%%.#,,,~~
~~~~,#..........#$$$$$.....$$$$#...######x#,,,~~
~~~,,#.((.(((.((########S#######.h.....9..o,,,~~
~~~,,#..........#*....;1;.....*#hOh...hO.*#,,,~~
~~~,,#.(((((...(#.....;;;......#.h...9.h..#,,,~~
~~~,,########x###...2..;...3...###x#####o##,,,~~
~~,,,,,,#...8...#.....hMh......#......#,,,,,,,~~
~~,,,,,,#.......#......;.......#......#,,,,,,,~~
~~,,,,,,#.......#......;.......#......#,,,,,,,~~
~~,,,,,,#.......#.....8;8......#......#,,,,,,,~~
~~,,,,,,##x###o####o###x###o#####o##x##,,,,,,,~~
~~,,,,,,#...#,,,,,,,##,.,##,,,,,,,#...#,,,,,,,~~
~~,,,,,,#...#,,,,,,,#,,.,,#,,,,,,,o...#,,,,,,,~~
~,,,,,,,#...o,,,,,,,,,,.,,,,,,,,,,#...#,,,,,,,~~
~,,,,,,,#...#,,,,,,##,,.,,##,,,,,,#...#,,,,,,,~~
~,,,,,,,#...#,,,,,,##.....##,,,,,,#...#,,,,,,,~~
~,,,,,,,#...#,,,,,,,..~~~.........x...#,,,,,,,~~
~,,,,,,,#...x........~~~~~.,,,,,,,#...#,,,,,,,~~
~,,,,,,,#...#,,,,,,,.~~~~~.,,,,,,,#...#,,,,,,,~~
~,,,,,,,#...#,,,,,,,..~~~..,,,,,,,#...#,,,,,,,~~
~,,,,,,,#9..o,,,,,,##.....##,,,,,,o...#,,,,,,,~~
~~,,,,,,#...#,,,,,,##,...,##,,,,,,#...#,,,,,,,~~
~~,,,#####x####,,,,,,,...,,,,,,,####x######,,,~~
~~~,,#........#,,,,,,,...,,,,,,,#.........#,,,~~
~~~,,o.=]..]=.###x####xxx####x###.=]...]=.o,,,~~
~~~,,#........#......#...#......#.........#,,,~~
~~~,,#.=]..]=.#....8.o...o.8....#.=]...]=.#,,~~~
~~~,,#........#......#...#......#.........#,,~~~
~~~,,#.=]..]=.#......#<..#......#.=]...]=.#,,,~~
~~~,,o........####o###!!!###o####....*....o,,~~~
~~~,,#.=]..]=.#,,,,,,8...8,,,,,,#.=]...]=.#~~~~~
~~~,,#...9...*#,,,,,,,...,,,,,,,#*.9......#~~~~~
~~~,,#####o####,,,,,,,...,,,,,,,#######o###~~~~~
 ~~,,,,,,,,,,,,,,,,,,,...,,,,,,,,,,,~~~~~~~~~~~~
~~~~~,,,,,,,,,,,,,,,,,...,,,,,,~~~~~~~~~~~~~~~~~
~~~~~~~~~~~~~~~~~~~~~~...~~~~~~~~~~~~~~~~~~~~~~~
~~~~~~~~~~~~~~~~~~~~~~...~~~~~~~~~~~~~~~~~~~~~~~
~~~~~~~~~~~~~~~~~~~~~~...~~~~~~~~~~~~~~~~~~~~~~~
~~~~~~~~~~~~~~~~~~~~~~...~~~~~~~~~~~~~~~~~~~~~~~
