#+++######
#...#....+
#...x....+
#x####x###
+..#.....#
+..x.....#
+..#.....#
####+++++#
