######++##
+...##..##
+...##..##
##.......+
##.......+
##..######
##..######
##++######
