####+++++#
####.....+
####.....+
####.....+
+........+
+.########
+........#
#####++++#
