####++####
####..####
####..####
+........+
+........+
####..####
####..####
####++####
