############
############
###,,,,,,###
###,,###,,##
+,,,####,,##
+,,##B,,,,##
+,,##,,,,,##
+,,,#,,,,###
##,,###,,###
###,,,,,,###
#####,,#####
############
