  ###+##  
  #....#  
  #....+  
  #....#  
  #....#  
  #....#  
  +....#  
  #....#  
  ##+###  
          
