  ###+##  
  #Oh..#  
  #h...#  
  #....#  
  +..*.+  
  #....#  
  #h...#  
  #Oh..#  
  ###+##  
          
