  ###+#   
  #...#   
  #...#   
  #...#   
  #...+   
  #...#   
  +...#   
  #...#   
  ##+##   
          
