#++++++++++#
+,,,,,,,,,,+
+,,,,,~~,,,+
+,~~,,,~~,,+
+,~~,,,,~,,+
+,~~~~,,~~,+
+,~~~~,,,~,+
+,,,~~~,,,,+
+,,,,~~~,,,+
+,,,,,,,,,,+
+,,,,,,,,,,+
#++++++++++#
