#++++++++++#
+&&&&&&&&&&+
+&&&&&&&&&&+
+&&&&~~~~&&+
+&&~~~~~~&&+
+&&~~,,~~&&+
+&~~~,,~~&&+
+&&~~~~~~&&+
+&&~~~~~&&&+
+&&&&&&&&&&+
+&&&&&&&&&&+
#++++++++++#
