#++++++++++#
+,,&&&&&,,,+
+,,&&&&&&&,+
+,,,~~~~&&,+
+,,,~~~~~&,+
+,,,,~~~~&&+
+,,,,,,~~&&+
+^~,,,,&&&&+
+^^,,,&&,,,+
+^^^,,,,,,,+
+^^^,,,,,,,+
#++++++++++#
