#++++++++++#
+,,&&&&&,,,+
+,,&&&&&&&,+
+,,&&&_&&&,+
+,,&&&;&&&,+
+,,&&&;&&&&+
+,&&&&;&&&&+
+,&,&&;&&&&+
+,,,&&;&,,,+
+,,,,,,,,,,+
+,,,,,,,,,,+
#++++++++++#
