^^###+##^^^^
^^^^,,,^^^^^
^^^,,,,^^^^^
^^^,,,,^^^^^
^^^,,,,^^^^^
^^^^,,,^^^^^
^^^^;^^^^^^^
^^^^;;;;<>;^
^^^^^^^^^^;^
^^^^^^^^^^^^
^^^^^^^^^^W^
^^^^^^^^^^^^
