                    
                    
    #####+#####     
    #.........##    
    #.A......A##    
    #....A....##    
    #.........##    
    #.........#     
    #####x#####     
      #*...*#       
      #.....#       
      #..<..#       
      ###>###       
      &&&;&&&       
     &&&&;;&&&      
     &&&&&;&&       
      &&&&;&&       
       &&&;&        
                    
                    
