+,+-+-,++
||L+|++||
|+T+++T+|
+-+---+-+
|F+TTT+,|
||F+|L,||
++L-+-+L+
